# 格式为日文[Tab]中文[Tab]解释(可不写)，参考项目wiki
# 角色

要	要	人名，男性，全名"中山要"（中山 要，なかやま かなめ），高二生，主人公，日常表现为有点笨拙、容易害羞、容易兴奋、口是心非、胆小但关键时刻会冲动行动的类型，后期逐渐大胆主导，对SM（特别是绳缚、拘束、羞耻play、露出系）有极度强烈的性癖和兴趣
かなめ	要	人名，男性，要的称呼
中山要	中山要	人名全名，男性，即"要"
中山	中山	人名姓氏，要的姓氏
カナちゃん	小要	人名，男性，要的称呼
要ちゃん	小要	人名，男性，要的称呼
中山君	中山君	人名，男性，要的称呼
要くん	要君	人名，男性，要的称呼
中山先輩	中山前辈	人名，男性，要的称呼
中山くん	中山君	人名，男性，要的称呼
かなめくん	要君	人名，男性，要的称呼
先輩	前辈	人名代称，通常指主人公"要"（男性，高二生）
ご主人さま	主人	人名代称，通常指主人公"要"（男性，高二生）

千佳	千佳	人名，女性，全名"御厨千佳"（御厨 千佳，みくりや ちか），高一生，要的后辈，聪明、直率、强势、挑衅的、冷静分析能力强，内心孤独但追求刺激、后期变得温柔且依赖要；对SM有兴趣，M侧倾向
御厨千佳	御厨千佳	人名全名，女性，即"千佳"
御厨	御厨	人名姓氏，千佳的姓氏

雫	雫	人名，女性，全名"小野原雫"（小野原 雫，おのはら しずく），高三生，要的青梅竹马＋邻居＋前辈，学园风纪委员长，清纯系美少女、成绩优秀、性格认真，实际上对SM（特别是被缚、羞耻、放置、轻度露出）有强烈兴趣和感受性
小野原雫	小野原雫	人名全名，女性，即"雫"
小野原	小野原	人名姓氏，雫的姓氏
雫姉さん	雫姐	人名，女性，雫的称呼
小野原さん	小野原同学	人名，女性，雫的称呼
雫ちゃん	小雫	人名，女性，雫的称呼

望美	望美	人名，女性，全名"柴崎望美"（柴崎 望美，しばさき のぞみ），26岁，老师，现代国语教师、水泳部顾问，胸部非常大、身材好、皮肤白、长发、温柔但有点天然呆/容易慌张的外表，私下对SM（特别是被缚、羞耻、露出、放置）有强烈兴趣和感受性，是重度M
柴崎望美	柴崎望美	人名全名，女性，即"望美"
柴崎	柴崎	人名姓氏，望美的姓氏
柴崎先生	柴崎老师	人名，女性，望美的称呼
望美先生	望美老师	人名，女性，望美的称呼
のぞみっち	望望	人名，女性，望美的称呼
のぞぴー	望皮皮	人名，女性，望美的称呼

要母	要母	人名代称，女性，要的妈妈
雫母	雫母	人名代称，女性，雫的妈妈
ナンパ男	搭讪男	人名代称，男性


お●●●ん	鸡鸡
お●●こ	小穴

ホープ	HOPE	人名/昵称，望美在杂志上的投稿名，长期投稿者，照片中常有绳缚、露出、学校教室、讲台等场景
ＢＤマガジン	BD Magazine	物品名，杂志
望美／要	望美／要	人名，两人同时说话
風紀委員長	风纪委员长	职位/头衔
Ｉフィールド	I力场	特殊物品，拘束棒名称
アナウンス	广播	一般名词
野曽原	野曾原	人名，教师
おばちゃん	阿姨	人名，女性
紅月ムー	红月穆	人名，SM专栏作者，要的知识来源之一
紅月ムー先生	红月穆老师	人名代称，SM专栏作者，要的知识来源之一
飼いならす	驯养	反复引用《星之王子》中小狐狸的名言，象征望美对“被特定的人驯养”的执念，也成为要和望美关系的象征性词汇